111111111
100000001
100011101
100000001
1000N0001
100000001
100010001
100010001
111111111